20 20
W W W W W W W W W W W W ) W W W W 4 W W
 W W S U W N W U U U W W W W U U W W W V
W W U W W W W W U W W W W U U W W U U W 
 W U W W U U W W U W W W U W W W W U W W
W W U W W U U W W U W W U W W W W U W W
 W W U W U W U U U W W U U W W W U W W W
W W W U U W W W W U W W U U W W W U W W
 W W U W W W W W W U W U W U W W W U W W
W W U W W U U W W W U U W W U U U U W W
 W U W W U W U W W W W W U W W W W W W W
W W U W U W U U U U W W W U U U U U U W
 W W U U W W W W W U U U W W W W W W U W
W W W U W W W W U U W W W W U U W W U W
 W W U U U W W U W U W E U U W U U U W W
W W U W W U U W W U W W W W W U W W W W
 W W U W W U U W W U W W W W U W W W W W
W W U W W W U U W W U U U W U U U W W W
 W U W W W W U W U W W W U U W W U W W W
W W U U U U U U U U W W U W W W W U W W
 W W W W W W W W W W W W W W W W W W W W